111111111
200000001
100000002
133333111