22222222222222222222222222222222
20000000000001000100000000000002
20E00000000001000100000001100002
20001100000001111100000001100002
20001100000000000000000001100002
20001100011110000010000001100002
20001100000010000000000001100002
20001100000000000010000001100002
20011111000055555550000001100002
20000000000000000000000001100002
20000000000011111140000000000002
20000000000013333340000000000002
20000000111110000040011111100002
20000000000000000040000000000002
20001100000000011100000001100002
20001100000000000000000001100002
20001100011111111100000001100002
20001100000000000005555551100002
20001100000000000000000001100002
20001100000002222000000001100002
20000000000P02B020T0000000000002
20000000000002002000000000000002
22222222222222222222222222222222
