11111111111111111111111111111111
10000000000001000100000000000001
10000000000001000100000001100001
10001100000001111100000001100001
10001100000000000000000001100001
10001100011110000010000001100001
10001100000010000000000001100001
10001100000000000010000001100001
10011111000055555550000001100001
10000000000000000000000001100001
10000000000011111140000000000001
10000000000013333340000000000001
10000000111110000040011111100001
10000000000000000040000000000001
10001100000000011100000001100001
10001100000000000000000001100001
10001100011111111100000001100001
10001100000000000005555551100001
10001100000000000000000001100001
10001100000002222000000001100001
10000000000P02B02000000000000001
10000000000002002000000000000001
11111111111111111111111111111111