1111111111111111111111111
1000000000000000000000001
1000000000000000000000001
1000000000000000001000001
1000000000000000000000001
1000000001111000001000001
1000000000001000000000001
1000000000000000001000001
1001111100000000000000001
1000000000000000000000001
1000000000001111110000001
1000000000001000000000001
1000000011111000000000001
1000000000000000000000001
1000000000000001110000001
1000000000000000000000001
1000000000000000000000001
1000000000000000000000001
1111111111111111111111111