2222222222222222222222222222
2000000000000100010000000002
2000000000000100010000000112
2000110000000111110000000112
2000110000000000000000000112
2000110001111000001000000112
2000110000001000000000000112
2000110000000000001000000112
2001111100005555555000000112
2000000000000000000000000112
2000000000001111114000000002
2000000000001333334000000002
2000000011111000004001111112
2000000000000000004000000002
2000000000000000004000000002
2000000000000000004000000002
2000000000000000004000000002
2000000000000000004000000002
2000000000000000004000000002
2000110000000001110000000112
2000110000000000000000000112
2000110001111111110000000112
2000110000000000000555555112
2000110000000000000000000112
2000110000000222200000000112
20000000000002B0200000000002
2000000000000200200000000002
2222222222222222222222222222