1111111111111111
3000000000000004
3000000000000004
3000000000000004
3000000000000004
3000000000000004
5222222222222226