0000110000000440000000110000
0000110000000440000000110000
0000110011100110011100110000
4444110011100010011100114444
4444110011100100011100114444
0000000000000010000000000000
0000000000000100000000000000
0404140414444114444041404140
4041414141441111441414141404
0414041404444114444040414040
0000000000000100000000000000
0000000000000010000000000000
0000000000000100000000000000
1111444333555015553334441111
1111444333555105553334441111
0000000000000010000000000000
0110000000000100000000000110
0110000000000010000000000110
0001100000222102220000011000
0001100000002012000000011000
0000011000000100000001100000
0000011000000010000001100000
0020000110000110000110000200
0020000111111111111110000200
0022000000000000000000002200
0000000000001111000000000000
0000000000001601000000000000
0000000000001001000000000000
