4440000002200440002200000444
4400000002200440002200000044
0000000000000330000000000000
0000000000000330000000000000
1111111111100330003333333300
1111111111100330004444444400
1111000000000330004444444400
1110000000033333300000000033
1100000000000000000000000000
1000111011110111101011000000
0000011010110100101011002200
0000011011110111101111002200
0000011000110100100011000000
0000011011110111100011000000
0000000000000000000000000000
0020022222444444442222200200
0000000000044444400000000000
0000000000004444000000000000
0000000000000440000000000000
0000110000000220000000110000
0000110000000220000000110000
1111110000000000000000111111
1111110011111001111100111111
0000000010000000000100000000
0000000010000000000100000000
0001111110011111100111111000
0000000000011601100000000000
0000000000011001100000000000
